Branch,City,Product line,Unit price,Quantity,stock_initial,jours_avant_peremption,surplus,jour_semaine,mois
Alex,Yangon,Health and beauty,74.69,7,13,17,6,5,1
Giza,Naypyitaw,Electronic accessories,15.28,5,24,21,19,4,3
Alex,Yangon,Home and lifestyle,46.33,7,35,14,28,6,3
Alex,Yangon,Health and beauty,58.22,8,22,9,14,6,1
Alex,Yangon,Sports and travel,86.31,7,17,46,10,4,2
Giza,Naypyitaw,Electronic accessories,85.39,7,14,1,7,0,3
Alex,Yangon,Electronic accessories,68.84,6,34,51,28,0,2
Giza,Naypyitaw,Home and lifestyle,73.56,10,30,45,20,6,2
Alex,Yangon,Health and beauty,36.26,2,8,13,6,3,1
Cairo,Mandalay,Food and beverages,54.84,3,28,4,25,2,2
Cairo,Mandalay,Fashion accessories,14.48,4,22,1,18,2,2
Cairo,Mandalay,Electronic accessories,25.51,4,26,49,22,5,3
Alex,Yangon,Electronic accessories,46.95,5,15,40,10,1,2
Alex,Yangon,Food and beverages,43.19,10,20,32,10,3,2
Alex,Yangon,Health and beauty,71.38,10,33,34,23,4,3
Cairo,Mandalay,Sports and travel,93.72,6,26,28,20,1,1
Alex,Yangon,Health and beauty,68.93,7,10,31,3,0,3
Alex,Yangon,Sports and travel,72.61,6,13,8,7,1,1
Alex,Yangon,Food and beverages,54.67,3,26,39,23,0,1
Cairo,Mandalay,Home and lifestyle,40.3,2,4,26,2,0,3
Giza,Naypyitaw,Electronic accessories,86.04,5,26,58,21,0,2
Cairo,Mandalay,Health and beauty,87.98,3,23,34,20,1,3
Cairo,Mandalay,Home and lifestyle,33.2,2,3,54,1,4,3
Alex,Yangon,Electronic accessories,34.56,5,28,54,23,6,2
Alex,Yangon,Sports and travel,88.63,3,14,3,11,5,3
Alex,Yangon,Home and lifestyle,52.59,8,37,59,29,4,3
Cairo,Mandalay,Fashion accessories,33.52,1,6,50,5,4,2
Alex,Yangon,Fashion accessories,87.67,2,3,12,1,6,3
Cairo,Mandalay,Food and beverages,88.36,5,32,1,27,4,1
Alex,Yangon,Health and beauty,24.89,9,29,54,20,4,3
Cairo,Mandalay,Fashion accessories,94.13,5,5,44,0,0,2
Cairo,Mandalay,Sports and travel,78.07,9,20,5,11,0,1
Cairo,Mandalay,Sports and travel,83.78,8,33,30,25,3,1
Alex,Yangon,Health and beauty,96.58,2,23,30,21,4,3
Giza,Naypyitaw,Food and beverages,99.42,4,32,59,28,2,2
Giza,Naypyitaw,Sports and travel,68.12,1,12,57,11,0,1
Alex,Yangon,Sports and travel,62.62,5,29,17,24,6,3
Alex,Yangon,Electronic accessories,60.88,9,25,48,16,1,1
Giza,Naypyitaw,Health and beauty,54.92,8,34,47,26,5,3
Cairo,Mandalay,Home and lifestyle,30.12,8,34,23,26,6,3
Cairo,Mandalay,Home and lifestyle,86.72,1,10,15,9,3,1
Giza,Naypyitaw,Home and lifestyle,56.11,2,29,37,27,5,2
Cairo,Mandalay,Sports and travel,69.12,6,33,21,27,4,2
Giza,Naypyitaw,Food and beverages,98.7,8,23,14,15,0,3
Giza,Naypyitaw,Health and beauty,15.37,2,16,2,14,5,3
Cairo,Mandalay,Electronic accessories,93.96,4,33,11,29,5,3
Cairo,Mandalay,Health and beauty,56.69,9,38,51,29,2,2
Cairo,Mandalay,Food and beverages,20.01,9,23,39,14,2,2
Cairo,Mandalay,Electronic accessories,18.93,6,35,38,29,6,2
Giza,Naypyitaw,Fashion accessories,82.63,10,28,34,18,1,3
Giza,Naypyitaw,Food and beverages,91.4,7,18,38,11,6,2
Alex,Yangon,Food and beverages,44.59,5,27,50,22,6,2
Cairo,Mandalay,Fashion accessories,17.87,4,23,34,19,4,3
Giza,Naypyitaw,Fashion accessories,15.43,1,25,18,24,4,1
Cairo,Mandalay,Home and lifestyle,16.16,2,4,30,2,3,3
Giza,Naypyitaw,Electronic accessories,85.98,8,12,15,4,3,2
Alex,Yangon,Home and lifestyle,44.34,2,20,27,18,2,3
Alex,Yangon,Health and beauty,89.6,8,14,51,6,3,2
Alex,Yangon,Home and lifestyle,72.35,10,30,34,20,6,1
Giza,Naypyitaw,Electronic accessories,30.61,6,14,52,8,1,3
Giza,Naypyitaw,Sports and travel,24.74,3,9,57,6,4,2
Giza,Naypyitaw,Home and lifestyle,55.73,6,23,38,17,6,2
Cairo,Mandalay,Sports and travel,55.07,9,12,33,3,6,2
Alex,Yangon,Sports and travel,15.81,10,34,24,24,2,3
Cairo,Mandalay,Health and beauty,75.74,4,31,15,27,3,2
Alex,Yangon,Health and beauty,15.87,10,23,30,13,2,3
Giza,Naypyitaw,Health and beauty,33.47,2,19,55,17,6,2
Cairo,Mandalay,Fashion accessories,97.61,6,31,42,25,0,1
Alex,Yangon,Sports and travel,78.77,10,18,51,8,3,1
Alex,Yangon,Health and beauty,18.33,1,26,17,25,5,2
Giza,Naypyitaw,Food and beverages,89.48,10,30,5,20,6,1
Giza,Naypyitaw,Fashion accessories,62.12,10,11,29,1,0,2
Cairo,Mandalay,Food and beverages,48.52,3,22,4,19,1,3
Giza,Naypyitaw,Electronic accessories,75.91,6,33,10,27,5,3
Alex,Yangon,Home and lifestyle,74.67,9,23,56,14,1,1
Giza,Naypyitaw,Electronic accessories,41.65,10,37,17,27,6,1
Giza,Naypyitaw,Fashion accessories,49.04,9,15,10,6,2,1
Alex,Yangon,Fashion accessories,20.01,9,20,17,11,5,1
Giza,Naypyitaw,Food and beverages,78.31,10,38,20,28,1,3
Giza,Naypyitaw,Health and beauty,20.38,5,12,24,7,1,1
Giza,Naypyitaw,Health and beauty,99.19,6,20,5,14,0,1
Cairo,Mandalay,Food and beverages,96.68,3,5,34,2,5,1
Giza,Naypyitaw,Food and beverages,19.25,8,21,6,13,2,1
Giza,Naypyitaw,Food and beverages,80.36,4,20,53,16,5,2
Giza,Naypyitaw,Sports and travel,48.91,5,8,2,3,5,3
Giza,Naypyitaw,Sports and travel,83.06,7,24,13,17,1,3
Giza,Naypyitaw,Fashion accessories,76.52,5,12,43,7,0,3
Alex,Yangon,Food and beverages,49.38,7,10,43,3,2,3
Alex,Yangon,Sports and travel,42.47,1,2,48,1,2,1
Cairo,Mandalay,Health and beauty,76.99,6,35,11,29,2,2
Giza,Naypyitaw,Home and lifestyle,47.38,4,9,51,5,2,1
Giza,Naypyitaw,Sports and travel,44.86,10,31,47,21,5,1
Alex,Yangon,Sports and travel,21.98,7,16,57,9,3,1
Cairo,Mandalay,Health and beauty,64.36,9,12,23,3,1,3
Giza,Naypyitaw,Health and beauty,89.75,1,22,55,21,2,2
Alex,Yangon,Electronic accessories,97.16,1,29,16,28,4,3
Cairo,Mandalay,Health and beauty,87.87,10,27,31,17,4,3
Giza,Naypyitaw,Electronic accessories,12.45,6,31,11,25,5,2
Alex,Yangon,Food and beverages,52.75,3,14,54,11,5,3
Cairo,Mandalay,Home and lifestyle,82.7,6,7,16,1,1,3
Giza,Naypyitaw,Fashion accessories,48.71,1,10,8,9,1,3
Giza,Naypyitaw,Fashion accessories,78.55,9,38,4,29,4,3
Giza,Naypyitaw,Electronic accessories,23.07,9,12,40,3,4,2
Alex,Yangon,Food and beverages,58.26,6,19,4,13,3,3
Cairo,Mandalay,Health and beauty,30.35,7,22,56,15,1,3
Alex,Yangon,Electronic accessories,88.67,10,24,25,14,5,1
Giza,Naypyitaw,Fashion accessories,27.38,6,13,3,7,5,1
Alex,Yangon,Sports and travel,62.13,6,19,32,13,4,3
Giza,Naypyitaw,Food and beverages,33.98,9,31,3,22,6,3
Giza,Naypyitaw,Electronic accessories,81.97,10,37,27,27,6,3
Cairo,Mandalay,Sports and travel,16.49,2,26,29,24,1,2
Giza,Naypyitaw,Health and beauty,98.21,3,32,32,29,1,2
Cairo,Mandalay,Fashion accessories,72.84,7,14,50,7,4,2
Alex,Yangon,Home and lifestyle,58.07,9,29,58,20,5,1
Giza,Naypyitaw,Home and lifestyle,80.79,9,24,51,15,4,2
Giza,Naypyitaw,Fashion accessories,27.02,3,15,19,12,5,3
Cairo,Mandalay,Fashion accessories,21.94,5,22,21,17,1,3
Cairo,Mandalay,Fashion accessories,51.36,1,15,5,14,2,1
Alex,Yangon,Food and beverages,10.96,10,30,18,20,5,2
Cairo,Mandalay,Home and lifestyle,53.44,2,25,28,23,6,1
Alex,Yangon,Electronic accessories,99.56,8,33,42,25,3,2
Giza,Naypyitaw,Sports and travel,57.12,7,31,22,24,5,1
Cairo,Mandalay,Sports and travel,99.96,9,36,21,27,5,3
Giza,Naypyitaw,Home and lifestyle,63.91,8,35,6,27,2,3
Cairo,Mandalay,Fashion accessories,56.47,8,35,1,27,5,3
Alex,Yangon,Home and lifestyle,93.69,7,19,5,12,6,3
Alex,Yangon,Sports and travel,32.25,5,13,41,8,6,1
Giza,Naypyitaw,Fashion accessories,31.73,9,37,12,28,1,1
Giza,Naypyitaw,Food and beverages,68.54,8,22,26,14,1,1
Cairo,Mandalay,Sports and travel,90.28,9,21,46,12,4,2
Cairo,Mandalay,Fashion accessories,39.62,7,7,34,0,4,1
Alex,Yangon,Sports and travel,92.13,6,30,49,24,2,3
Cairo,Mandalay,Sports and travel,34.84,4,10,14,6,6,2
Cairo,Mandalay,Electronic accessories,87.45,6,14,26,8,6,2
Giza,Naypyitaw,Health and beauty,81.3,6,29,45,23,4,3
Giza,Naypyitaw,Fashion accessories,90.22,3,3,27,0,0,2
Alex,Yangon,Electronic accessories,26.31,5,16,9,11,4,1
Alex,Yangon,Home and lifestyle,34.42,6,13,26,7,0,2
Cairo,Mandalay,Sports and travel,51.91,10,33,57,23,5,2
Alex,Yangon,Sports and travel,72.5,8,18,47,10,5,3
Giza,Naypyitaw,Sports and travel,89.8,10,28,57,18,2,1
Giza,Naypyitaw,Health and beauty,90.5,10,26,22,16,4,1
Giza,Naypyitaw,Health and beauty,68.6,10,17,47,7,1,2
Giza,Naypyitaw,Food and beverages,30.41,1,3,56,2,4,2
Alex,Yangon,Home and lifestyle,77.95,6,8,30,2,0,1
Giza,Naypyitaw,Health and beauty,46.26,6,6,43,0,4,3
Alex,Yangon,Fashion accessories,30.14,10,36,48,26,6,2
Giza,Naypyitaw,Health and beauty,66.14,4,8,17,4,1,3
Cairo,Mandalay,Home and lifestyle,71.86,8,17,26,9,2,3
Alex,Yangon,Health and beauty,32.46,8,14,36,6,2,3
Cairo,Mandalay,Fashion accessories,91.54,4,29,1,25,5,3
Giza,Naypyitaw,Sports and travel,34.56,7,15,8,8,0,3
Alex,Yangon,Fashion accessories,83.24,9,36,49,27,1,1
Giza,Naypyitaw,Food and beverages,16.48,6,12,35,6,3,2
Giza,Naypyitaw,Sports and travel,80.97,8,16,52,8,0,1
Alex,Yangon,Food and beverages,92.29,5,12,15,7,2,2
Cairo,Mandalay,Electronic accessories,72.17,1,12,47,11,4,1
Cairo,Mandalay,Home and lifestyle,50.28,5,6,56,1,3,3
Cairo,Mandalay,Health and beauty,97.22,9,9,22,0,5,3
Cairo,Mandalay,Sports and travel,93.39,6,21,14,15,2,3
Giza,Naypyitaw,Food and beverages,43.18,8,30,26,22,5,1
Alex,Yangon,Sports and travel,63.69,1,23,28,22,0,2
Alex,Yangon,Food and beverages,45.79,7,36,23,29,2,3
Giza,Naypyitaw,Sports and travel,76.4,2,25,14,23,2,1
Cairo,Mandalay,Food and beverages,39.9,10,14,24,4,2,2
Cairo,Mandalay,Health and beauty,42.57,8,10,2,2,0,2
Giza,Naypyitaw,Home and lifestyle,95.58,10,21,45,11,2,1
Alex,Yangon,Fashion accessories,98.98,10,17,26,7,4,2
Alex,Yangon,Food and beverages,51.28,6,27,14,21,5,1
Alex,Yangon,Sports and travel,69.52,7,33,59,26,4,2
Alex,Yangon,Health and beauty,70.01,5,7,56,2,3,1
Cairo,Mandalay,Food and beverages,80.05,5,5,51,0,5,1
Giza,Naypyitaw,Electronic accessories,20.85,8,10,7,2,6,3
Cairo,Mandalay,Electronic accessories,52.89,6,10,3,4,5,1
Cairo,Mandalay,Food and beverages,19.79,8,22,47,14,4,1
Alex,Yangon,Home and lifestyle,33.84,9,22,23,13,3,3
Alex,Yangon,Food and beverages,22.17,8,10,46,2,6,3
Giza,Naypyitaw,Fashion accessories,22.51,7,7,43,0,2,2
Alex,Yangon,Food and beverages,73.88,6,10,47,4,5,3
Giza,Naypyitaw,Health and beauty,86.8,3,28,45,25,0,1
Giza,Naypyitaw,Fashion accessories,64.26,7,29,18,22,5,2
Giza,Naypyitaw,Food and beverages,38.47,8,21,58,13,2,1
Alex,Yangon,Sports and travel,15.5,10,16,38,6,5,3
Giza,Naypyitaw,Health and beauty,34.31,8,34,35,26,4,1
Alex,Yangon,Sports and travel,12.34,7,15,51,8,0,3
Cairo,Mandalay,Food and beverages,18.08,3,17,15,14,1,3
Cairo,Mandalay,Home and lifestyle,94.49,8,22,25,14,6,3
Cairo,Mandalay,Home and lifestyle,46.47,4,29,55,25,4,2
Alex,Yangon,Home and lifestyle,74.07,1,10,37,9,6,2
Giza,Naypyitaw,Home and lifestyle,69.81,4,31,28,27,0,1
Cairo,Mandalay,Home and lifestyle,77.04,3,15,10,12,0,2
Cairo,Mandalay,Fashion accessories,73.52,2,20,39,18,1,1
Giza,Naypyitaw,Food and beverages,87.8,9,15,57,6,5,3
Cairo,Mandalay,Home and lifestyle,25.55,4,20,17,16,5,1
Alex,Yangon,Electronic accessories,32.71,5,24,39,19,1,3
Giza,Naypyitaw,Fashion accessories,74.29,1,29,22,28,6,1
Giza,Naypyitaw,Health and beauty,43.7,2,5,26,3,1,3
Alex,Yangon,Home and lifestyle,25.29,1,30,44,29,5,3
Giza,Naypyitaw,Health and beauty,41.5,4,8,25,4,1,3
Giza,Naypyitaw,Food and beverages,71.39,5,27,17,22,6,2
Giza,Naypyitaw,Sports and travel,19.15,6,12,13,6,1,1
Cairo,Mandalay,Electronic accessories,57.49,4,16,20,12,4,3
Giza,Naypyitaw,Electronic accessories,61.41,7,21,25,14,0,1
Cairo,Mandalay,Health and beauty,25.9,10,20,4,10,2,2
Cairo,Mandalay,Home and lifestyle,17.77,5,33,10,28,4,2
Alex,Yangon,Health and beauty,23.03,9,12,3,3,3,1
Giza,Naypyitaw,Electronic accessories,66.65,9,21,41,12,4,1
Giza,Naypyitaw,Home and lifestyle,28.53,10,16,45,6,0,3
Cairo,Mandalay,Fashion accessories,30.37,3,29,18,26,3,3
Cairo,Mandalay,Electronic accessories,99.73,9,27,47,18,5,3
Alex,Yangon,Electronic accessories,26.23,9,30,36,21,4,1
Giza,Naypyitaw,Food and beverages,93.26,9,36,47,27,2,1
Cairo,Mandalay,Home and lifestyle,92.36,5,6,22,1,2,3
Cairo,Mandalay,Sports and travel,46.42,3,12,34,9,4,1
Cairo,Mandalay,Sports and travel,29.61,7,19,47,12,0,3
Alex,Yangon,Home and lifestyle,18.28,1,30,8,29,4,3
Cairo,Mandalay,Sports and travel,24.77,5,29,40,24,6,3
Alex,Yangon,Electronic accessories,94.64,3,23,49,20,3,2
Cairo,Mandalay,Fashion accessories,94.87,8,13,44,5,1,2
Cairo,Mandalay,Food and beverages,57.34,3,30,19,27,6,3
Cairo,Mandalay,Electronic accessories,45.35,6,33,42,27,3,1
Cairo,Mandalay,Food and beverages,62.08,7,18,41,11,2,3
Giza,Naypyitaw,Electronic accessories,11.81,5,16,37,11,6,2
Giza,Naypyitaw,Fashion accessories,12.54,1,20,6,19,3,2
Alex,Yangon,Food and beverages,43.25,2,31,52,29,2,3
Giza,Naypyitaw,Sports and travel,87.16,2,31,26,29,4,1
Cairo,Mandalay,Health and beauty,69.37,9,19,34,10,5,1
Giza,Naypyitaw,Electronic accessories,37.06,4,29,59,25,3,1
Cairo,Mandalay,Electronic accessories,90.7,6,28,56,22,1,2
Alex,Yangon,Home and lifestyle,63.42,8,35,59,27,0,3
Cairo,Mandalay,Fashion accessories,81.37,2,26,45,24,5,1
Cairo,Mandalay,Electronic accessories,10.59,3,9,6,6,1,3
Cairo,Mandalay,Health and beauty,84.09,9,38,37,29,0,2
Cairo,Mandalay,Fashion accessories,73.82,4,4,57,0,3,2
Alex,Yangon,Health and beauty,51.94,10,10,33,0,5,3
Alex,Yangon,Sports and travel,93.14,2,26,53,24,6,1
Giza,Naypyitaw,Health and beauty,17.41,5,31,22,26,0,1
Giza,Naypyitaw,Fashion accessories,44.22,5,34,21,29,1,3
Cairo,Mandalay,Electronic accessories,13.22,5,29,6,24,5,3
Alex,Yangon,Fashion accessories,89.69,1,20,6,19,4,1
Alex,Yangon,Food and beverages,24.94,9,21,55,12,4,1
Alex,Yangon,Health and beauty,59.77,2,10,48,8,0,3
Giza,Naypyitaw,Fashion accessories,93.2,2,4,4,2,3,2
Alex,Yangon,Home and lifestyle,62.65,4,10,30,6,5,1
Cairo,Mandalay,Home and lifestyle,93.87,8,13,11,5,5,2
Alex,Yangon,Home and lifestyle,47.59,8,15,30,7,1,1
Cairo,Mandalay,Electronic accessories,81.4,3,29,31,26,5,2
Alex,Yangon,Fashion accessories,17.94,5,13,24,8,2,1
Alex,Yangon,Electronic accessories,77.72,4,33,55,29,0,1
Cairo,Mandalay,Food and beverages,73.06,7,11,9,4,0,1
Cairo,Mandalay,Food and beverages,46.55,9,9,55,0,5,2
Giza,Naypyitaw,Fashion accessories,35.19,10,28,3,18,6,3
Giza,Naypyitaw,Sports and travel,14.39,2,11,51,9,5,3
Alex,Yangon,Home and lifestyle,23.75,4,15,31,11,5,3
Alex,Yangon,Home and lifestyle,58.9,8,31,40,23,6,1
Cairo,Mandalay,Fashion accessories,32.62,4,18,37,14,1,1
Alex,Yangon,Electronic accessories,66.35,1,27,36,26,3,1
Alex,Yangon,Home and lifestyle,25.91,6,27,24,21,1,2
Alex,Yangon,Electronic accessories,32.25,4,27,31,23,2,2
Giza,Naypyitaw,Electronic accessories,65.94,4,12,6,8,3,2
Alex,Yangon,Electronic accessories,75.06,9,28,2,19,1,3
Giza,Naypyitaw,Fashion accessories,16.45,4,20,20,16,3,3
Cairo,Mandalay,Fashion accessories,38.3,4,33,28,29,2,3
Alex,Yangon,Sports and travel,22.24,10,26,11,16,5,2
Cairo,Mandalay,Sports and travel,54.45,1,26,4,25,1,2
Alex,Yangon,Sports and travel,98.4,7,26,15,19,1,3
Giza,Naypyitaw,Home and lifestyle,35.47,4,15,6,11,3,3
Cairo,Mandalay,Food and beverages,74.6,10,39,54,29,1,1
Alex,Yangon,Home and lifestyle,70.74,4,10,49,6,5,1
Alex,Yangon,Home and lifestyle,35.54,10,11,30,1,4,1
Cairo,Mandalay,Sports and travel,67.43,5,7,56,2,2,3
Giza,Naypyitaw,Health and beauty,21.12,2,18,38,16,3,1
Alex,Yangon,Home and lifestyle,21.54,9,13,51,4,0,1
Alex,Yangon,Home and lifestyle,12.03,2,18,57,16,6,1
Cairo,Mandalay,Health and beauty,99.71,6,29,2,23,1,2
Cairo,Mandalay,Fashion accessories,47.97,7,23,15,16,0,1
Giza,Naypyitaw,Home and lifestyle,21.82,10,36,11,26,0,1
Giza,Naypyitaw,Fashion accessories,95.42,4,20,8,16,5,2
Giza,Naypyitaw,Fashion accessories,70.99,10,11,26,1,2,3
Alex,Yangon,Sports and travel,44.02,10,11,51,1,2,3
Alex,Yangon,Home and lifestyle,69.96,8,35,45,27,4,2
Giza,Naypyitaw,Home and lifestyle,37.0,1,22,44,21,2,3
Alex,Yangon,Sports and travel,15.34,1,23,5,22,6,1
Alex,Yangon,Health and beauty,99.83,6,10,6,4,0,3
Alex,Yangon,Health and beauty,47.67,4,4,26,0,1,3
Cairo,Mandalay,Health and beauty,66.68,5,5,54,0,2,2
Giza,Naypyitaw,Home and lifestyle,74.86,1,19,4,18,6,3
Giza,Naypyitaw,Sports and travel,23.75,9,38,19,29,3,1
Cairo,Mandalay,Food and beverages,48.51,7,8,20,1,4,1
Alex,Yangon,Home and lifestyle,94.88,7,27,33,20,6,2
Cairo,Mandalay,Electronic accessories,40.3,10,21,20,11,3,1
Giza,Naypyitaw,Electronic accessories,27.85,7,32,49,25,3,3
Alex,Yangon,Electronic accessories,62.48,1,6,12,5,0,2
Alex,Yangon,Food and beverages,36.36,2,24,47,22,0,1
Cairo,Mandalay,Health and beauty,18.11,10,13,1,3,2,3
Giza,Naypyitaw,Electronic accessories,51.92,5,27,26,22,6,3
Giza,Naypyitaw,Electronic accessories,28.84,4,14,14,10,4,3
Alex,Yangon,Home and lifestyle,78.38,6,29,38,23,3,1
Alex,Yangon,Home and lifestyle,60.01,4,30,37,26,4,1
Giza,Naypyitaw,Home and lifestyle,88.61,1,17,11,16,5,1
Giza,Naypyitaw,Fashion accessories,99.82,2,7,36,5,2,1
Cairo,Mandalay,Health and beauty,39.01,1,24,13,23,1,3
Giza,Naypyitaw,Food and beverages,48.61,1,5,43,4,0,2
Alex,Yangon,Electronic accessories,51.19,4,23,3,19,0,3
Cairo,Mandalay,Electronic accessories,14.96,8,9,33,1,5,2
Alex,Yangon,Electronic accessories,72.2,7,12,6,5,1,3
Alex,Yangon,Sports and travel,40.23,7,28,50,21,5,3
Alex,Yangon,Home and lifestyle,88.79,8,18,56,10,6,2
Alex,Yangon,Electronic accessories,26.48,3,18,10,15,3,3
Alex,Yangon,Fashion accessories,81.91,2,17,5,15,1,3
Cairo,Mandalay,Sports and travel,79.93,6,6,23,0,3,1
Giza,Naypyitaw,Fashion accessories,69.33,2,10,10,8,1,2
Alex,Yangon,Food and beverages,14.23,5,32,44,27,4,2
Alex,Yangon,Health and beauty,15.55,9,35,2,26,3,3
Giza,Naypyitaw,Electronic accessories,78.13,10,15,13,5,6,2
Giza,Naypyitaw,Food and beverages,99.37,2,17,40,15,3,2
Giza,Naypyitaw,Food and beverages,21.08,3,31,2,28,5,2
Giza,Naypyitaw,Electronic accessories,74.79,5,7,20,2,3,1
Giza,Naypyitaw,Health and beauty,29.67,7,26,1,19,0,3
Giza,Naypyitaw,Health and beauty,44.07,4,31,37,27,0,2
Giza,Naypyitaw,Food and beverages,22.93,9,35,9,26,1,2
Giza,Naypyitaw,Health and beauty,39.42,1,4,17,3,4,1
Alex,Yangon,Health and beauty,15.26,6,24,9,18,4,2
Alex,Yangon,Fashion accessories,61.77,5,30,11,25,4,3
Alex,Yangon,Home and lifestyle,21.52,6,8,15,2,3,1
Cairo,Mandalay,Sports and travel,97.74,4,22,24,18,1,3
Alex,Yangon,Food and beverages,99.78,5,24,38,19,5,3
Giza,Naypyitaw,Food and beverages,94.26,4,10,55,6,1,3
Cairo,Mandalay,Health and beauty,51.13,4,23,35,19,4,1
Alex,Yangon,Electronic accessories,36.36,4,12,30,8,0,3
Cairo,Mandalay,Home and lifestyle,22.02,9,9,31,0,3,2
Alex,Yangon,Food and beverages,32.9,3,10,49,7,6,2
Alex,Yangon,Fashion accessories,77.02,5,11,5,6,6,2
Alex,Yangon,Food and beverages,23.48,2,19,44,17,3,3
Giza,Naypyitaw,Sports and travel,14.7,5,12,50,7,6,3
Alex,Yangon,Electronic accessories,28.45,5,5,14,0,3,3
Alex,Yangon,Fashion accessories,76.4,9,19,53,10,1,3
Cairo,Mandalay,Sports and travel,57.95,6,33,56,27,6,2
Giza,Naypyitaw,Electronic accessories,47.65,3,27,11,24,3,3
Cairo,Mandalay,Food and beverages,42.82,9,33,9,24,1,2
Cairo,Mandalay,Electronic accessories,48.09,3,20,34,17,6,2
Cairo,Mandalay,Health and beauty,55.97,7,29,12,22,1,3
Cairo,Mandalay,Health and beauty,76.9,7,36,35,29,4,2
Giza,Naypyitaw,Food and beverages,97.03,5,14,35,9,2,1
Alex,Yangon,Sports and travel,44.65,3,5,1,2,3,2
Alex,Yangon,Fashion accessories,77.93,9,15,40,6,2,2
Alex,Yangon,Electronic accessories,71.95,1,28,22,27,0,2
Giza,Naypyitaw,Home and lifestyle,89.25,8,23,29,15,6,1
Alex,Yangon,Electronic accessories,26.02,7,32,8,25,3,3
Cairo,Mandalay,Health and beauty,13.5,10,25,11,15,2,2
Giza,Naypyitaw,Fashion accessories,99.3,10,34,41,24,4,2
Alex,Yangon,Electronic accessories,51.69,7,26,37,19,5,1
Cairo,Mandalay,Fashion accessories,54.73,7,34,14,27,3,3
Cairo,Mandalay,Home and lifestyle,27.0,9,25,30,16,5,3
Giza,Naypyitaw,Electronic accessories,30.24,1,2,35,1,0,3
Cairo,Mandalay,Food and beverages,89.14,4,4,21,0,0,1
Giza,Naypyitaw,Fashion accessories,37.55,10,25,37,15,4,3
Giza,Naypyitaw,Sports and travel,95.44,10,39,5,29,2,1
Cairo,Mandalay,Electronic accessories,27.5,3,14,19,11,4,3
Cairo,Mandalay,Sports and travel,74.97,1,5,59,4,5,3
Alex,Yangon,Food and beverages,80.96,8,12,14,4,6,2
Giza,Naypyitaw,Food and beverages,94.47,8,34,26,26,2,2
Giza,Naypyitaw,Food and beverages,99.79,2,24,4,22,3,3
Alex,Yangon,Home and lifestyle,73.22,6,14,25,8,0,1
Giza,Naypyitaw,Food and beverages,41.24,4,12,45,8,1,2
Giza,Naypyitaw,Fashion accessories,81.68,4,6,42,2,6,1
Giza,Naypyitaw,Electronic accessories,51.32,9,27,25,18,3,3
Alex,Yangon,Home and lifestyle,65.94,4,19,18,15,6,3
Giza,Naypyitaw,Sports and travel,14.36,10,25,40,15,6,1
Alex,Yangon,Electronic accessories,21.5,9,11,8,2,2,3
Cairo,Mandalay,Electronic accessories,26.26,7,26,39,19,5,2
Cairo,Mandalay,Fashion accessories,60.96,2,25,40,23,4,1
Giza,Naypyitaw,Home and lifestyle,70.11,6,27,14,21,3,3
Giza,Naypyitaw,Fashion accessories,42.08,6,29,32,23,1,1
Alex,Yangon,Home and lifestyle,67.09,5,5,51,0,3,1
Alex,Yangon,Fashion accessories,96.7,5,28,38,23,0,1
Cairo,Mandalay,Home and lifestyle,35.38,9,28,33,19,5,1
Giza,Naypyitaw,Sports and travel,95.49,7,17,23,10,4,2
Giza,Naypyitaw,Fashion accessories,96.98,4,20,15,16,2,2
Cairo,Mandalay,Electronic accessories,23.65,4,11,33,7,2,1
Alex,Yangon,Sports and travel,82.33,4,7,25,3,4,1
Giza,Naypyitaw,Electronic accessories,26.61,2,7,17,5,1,3
Cairo,Mandalay,Food and beverages,99.69,5,12,33,7,0,1
Giza,Naypyitaw,Food and beverages,74.89,4,23,47,19,4,3
Alex,Yangon,Food and beverages,40.94,5,34,55,29,6,1
Cairo,Mandalay,Sports and travel,75.82,1,3,2,2,3,1
Giza,Naypyitaw,Food and beverages,46.77,6,21,14,15,0,3
Alex,Yangon,Health and beauty,32.32,10,39,53,29,2,2
Giza,Naypyitaw,Fashion accessories,54.07,9,33,40,24,6,1
Cairo,Mandalay,Food and beverages,18.22,7,9,40,2,6,3
Giza,Naypyitaw,Fashion accessories,80.48,3,27,51,24,4,2
Cairo,Mandalay,Fashion accessories,37.95,10,38,39,28,5,1
Alex,Yangon,Electronic accessories,76.82,1,18,51,17,2,2
Alex,Yangon,Sports and travel,52.26,10,23,6,13,5,3
Alex,Yangon,Health and beauty,79.74,1,18,6,17,2,3
Alex,Yangon,Health and beauty,77.5,5,6,3,1,3,1
Alex,Yangon,Food and beverages,54.27,5,26,7,21,2,3
Cairo,Mandalay,Home and lifestyle,13.59,9,11,51,2,4,3
Cairo,Mandalay,Health and beauty,41.06,6,21,8,15,1,3
Cairo,Mandalay,Electronic accessories,19.24,9,37,42,28,0,3
Giza,Naypyitaw,Food and beverages,39.43,6,14,52,8,0,3
Giza,Naypyitaw,Home and lifestyle,46.22,4,7,15,3,1,3
Giza,Naypyitaw,Home and lifestyle,13.98,1,1,47,0,0,2
Cairo,Mandalay,Fashion accessories,39.75,5,8,29,3,4,2
Giza,Naypyitaw,Fashion accessories,97.79,7,7,33,0,5,2
Alex,Yangon,Sports and travel,67.26,4,17,52,13,5,1
Alex,Yangon,Food and beverages,13.79,5,25,30,20,4,1
Cairo,Mandalay,Fashion accessories,68.71,4,19,39,15,4,1
Alex,Yangon,Home and lifestyle,56.53,4,23,27,19,0,3
Giza,Naypyitaw,Fashion accessories,23.82,5,28,36,23,0,1
Cairo,Mandalay,Health and beauty,34.21,10,17,29,7,2,1
Cairo,Mandalay,Sports and travel,21.87,2,8,38,6,4,1
Alex,Yangon,Health and beauty,20.97,5,7,57,2,4,1
Alex,Yangon,Sports and travel,25.84,3,19,33,16,6,3
Alex,Yangon,Home and lifestyle,50.93,8,8,37,0,4,3
Cairo,Mandalay,Health and beauty,96.11,1,16,27,15,4,1
Giza,Naypyitaw,Home and lifestyle,45.38,4,15,55,11,1,1
Giza,Naypyitaw,Health and beauty,81.51,1,27,33,26,1,1
Cairo,Mandalay,Health and beauty,57.22,2,20,4,18,5,1
Alex,Yangon,Electronic accessories,25.22,7,28,22,21,0,2
Giza,Naypyitaw,Food and beverages,38.6,3,25,2,22,3,3
Giza,Naypyitaw,Electronic accessories,84.05,3,24,10,21,2,1
Giza,Naypyitaw,Fashion accessories,97.21,10,23,5,13,4,2
Cairo,Mandalay,Fashion accessories,25.42,8,37,59,29,1,3
Giza,Naypyitaw,Fashion accessories,16.28,1,6,10,5,5,3
Cairo,Mandalay,Fashion accessories,40.61,9,14,33,5,2,1
Alex,Yangon,Health and beauty,53.17,7,19,54,12,0,1
Cairo,Mandalay,Food and beverages,20.87,3,21,38,18,2,3
Cairo,Mandalay,Sports and travel,67.27,5,26,13,21,2,2
Alex,Yangon,Home and lifestyle,90.65,10,17,31,7,4,3
Cairo,Mandalay,Fashion accessories,69.08,2,28,47,26,3,1
Giza,Naypyitaw,Food and beverages,43.27,2,28,36,26,4,3
Alex,Yangon,Electronic accessories,23.46,6,7,45,1,6,1
Cairo,Mandalay,Fashion accessories,95.54,7,27,24,20,5,3
Cairo,Mandalay,Fashion accessories,47.44,1,30,52,29,4,2
Giza,Naypyitaw,Sports and travel,99.24,9,9,56,0,1,3
Giza,Naypyitaw,Sports and travel,82.93,4,31,15,27,6,1
Alex,Yangon,Home and lifestyle,33.99,6,20,29,14,4,3
Giza,Naypyitaw,Food and beverages,17.04,4,4,8,0,4,3
Giza,Naypyitaw,Electronic accessories,40.86,8,12,5,4,3,2
Giza,Naypyitaw,Food and beverages,17.44,5,32,29,27,1,1
Cairo,Mandalay,Sports and travel,88.43,8,36,47,28,4,3
Alex,Yangon,Home and lifestyle,89.21,9,24,4,15,1,1
Giza,Naypyitaw,Fashion accessories,12.78,1,19,12,18,1,1
Alex,Yangon,Sports and travel,19.1,7,10,45,3,1,1
Cairo,Mandalay,Health and beauty,19.15,1,3,2,2,0,1
Giza,Naypyitaw,Food and beverages,27.66,10,26,27,16,3,2
Giza,Naypyitaw,Fashion accessories,45.74,3,19,31,16,6,3
Cairo,Mandalay,Health and beauty,27.07,1,12,51,11,5,1
Cairo,Mandalay,Sports and travel,39.12,1,28,51,27,1,3
Cairo,Mandalay,Electronic accessories,74.71,6,35,36,29,1,1
Cairo,Mandalay,Electronic accessories,22.01,6,34,36,28,2,1
Alex,Yangon,Food and beverages,63.61,5,18,26,13,5,3
Alex,Yangon,Health and beauty,25.0,1,21,43,20,6,3
Alex,Yangon,Electronic accessories,20.77,4,9,27,5,3,1
Cairo,Mandalay,Fashion accessories,29.56,5,7,5,2,2,2
Cairo,Mandalay,Food and beverages,77.4,9,36,20,27,4,2
Cairo,Mandalay,Electronic accessories,79.39,10,18,11,8,3,2
Giza,Naypyitaw,Electronic accessories,46.57,10,14,10,4,6,1
Giza,Naypyitaw,Food and beverages,35.89,1,24,40,23,5,2
Giza,Naypyitaw,Food and beverages,40.52,5,33,38,28,6,2
Cairo,Mandalay,Food and beverages,73.05,10,26,6,16,6,3
Giza,Naypyitaw,Sports and travel,73.95,4,17,8,13,6,2
Giza,Naypyitaw,Food and beverages,22.62,1,21,23,20,6,3
Alex,Yangon,Food and beverages,51.34,5,7,47,2,3,3
Giza,Naypyitaw,Sports and travel,54.55,10,37,26,27,5,3
Giza,Naypyitaw,Health and beauty,37.15,7,7,46,0,4,2
Cairo,Mandalay,Sports and travel,37.02,6,25,43,19,4,3
Giza,Naypyitaw,Food and beverages,21.58,1,29,12,28,5,2
Giza,Naypyitaw,Electronic accessories,98.84,1,21,26,20,4,2
Giza,Naypyitaw,Home and lifestyle,83.77,6,28,13,22,2,1
Alex,Yangon,Sports and travel,40.05,4,4,40,0,4,1
Alex,Yangon,Fashion accessories,43.13,10,12,18,2,5,2
Cairo,Mandalay,Health and beauty,72.57,8,25,25,17,5,3
Alex,Yangon,Electronic accessories,64.44,5,29,33,24,5,3
Alex,Yangon,Health and beauty,65.18,3,12,47,9,0,2
Alex,Yangon,Sports and travel,33.26,5,26,40,21,0,3
Giza,Naypyitaw,Electronic accessories,84.07,4,29,43,25,3,3
Cairo,Mandalay,Sports and travel,34.37,10,12,12,2,5,3
Alex,Yangon,Electronic accessories,38.6,1,8,44,7,1,1
Giza,Naypyitaw,Food and beverages,65.97,8,21,36,13,5,2
Giza,Naypyitaw,Electronic accessories,32.8,10,33,48,23,4,2
Alex,Yangon,Sports and travel,37.14,5,22,4,17,1,1
Cairo,Mandalay,Home and lifestyle,60.38,10,24,5,14,1,2
Giza,Naypyitaw,Sports and travel,36.98,10,31,56,21,1,1
Cairo,Mandalay,Sports and travel,49.49,4,26,37,22,3,3
Cairo,Mandalay,Fashion accessories,41.09,10,11,8,1,3,2
Alex,Yangon,Fashion accessories,37.15,4,30,42,26,5,3
Giza,Naypyitaw,Home and lifestyle,22.96,1,10,49,9,2,1
Cairo,Mandalay,Home and lifestyle,77.68,9,10,28,1,0,2
Cairo,Mandalay,Fashion accessories,34.7,2,27,31,25,2,3
Alex,Yangon,Fashion accessories,19.66,10,26,58,16,4,3
Cairo,Mandalay,Health and beauty,25.32,8,15,9,7,1,3
Giza,Naypyitaw,Home and lifestyle,12.12,10,10,54,0,1,3
Cairo,Mandalay,Fashion accessories,99.89,2,10,51,8,1,2
Cairo,Mandalay,Sports and travel,75.92,8,18,29,10,2,3
Giza,Naypyitaw,Electronic accessories,63.22,2,23,14,21,1,1
Giza,Naypyitaw,Food and beverages,90.24,6,21,40,15,6,1
Cairo,Mandalay,Sports and travel,98.13,1,7,41,6,0,1
Alex,Yangon,Sports and travel,51.52,8,36,22,28,5,2
Cairo,Mandalay,Sports and travel,73.97,1,10,11,9,6,2
Giza,Naypyitaw,Fashion accessories,31.9,1,23,23,22,5,1
Giza,Naypyitaw,Home and lifestyle,69.4,2,27,1,25,6,1
Cairo,Mandalay,Sports and travel,93.31,2,4,46,2,0,3
Cairo,Mandalay,Sports and travel,88.45,1,18,37,17,0,2
Alex,Yangon,Electronic accessories,24.18,8,32,21,24,0,1
Cairo,Mandalay,Sports and travel,48.5,3,26,26,23,1,1
Cairo,Mandalay,Food and beverages,84.05,6,18,46,12,1,1
Cairo,Mandalay,Health and beauty,61.29,5,32,36,27,4,3
Giza,Naypyitaw,Home and lifestyle,15.95,6,31,54,25,5,2
Cairo,Mandalay,Sports and travel,90.74,7,13,23,6,2,1
Alex,Yangon,Home and lifestyle,42.91,5,29,57,24,5,1
Alex,Yangon,Fashion accessories,54.28,7,10,1,3,6,1
Alex,Yangon,Electronic accessories,99.55,7,19,54,12,3,3
Giza,Naypyitaw,Sports and travel,58.39,7,26,55,19,5,2
Giza,Naypyitaw,Fashion accessories,51.47,1,1,51,0,0,3
Cairo,Mandalay,Health and beauty,54.86,5,12,40,7,4,3
Giza,Naypyitaw,Home and lifestyle,39.39,5,18,15,13,1,1
Alex,Yangon,Home and lifestyle,34.73,2,17,21,15,4,3
Giza,Naypyitaw,Sports and travel,71.92,5,18,47,13,3,1
Cairo,Mandalay,Electronic accessories,45.71,3,14,9,11,1,3
Giza,Naypyitaw,Home and lifestyle,83.17,6,24,53,18,2,3
Alex,Yangon,Home and lifestyle,37.44,6,28,9,22,2,2
Giza,Naypyitaw,Health and beauty,62.87,2,16,10,14,1,1
Alex,Yangon,Food and beverages,81.71,6,33,52,27,6,1
Alex,Yangon,Sports and travel,91.41,5,6,57,1,0,2
Cairo,Mandalay,Fashion accessories,39.21,4,5,53,1,2,1
Cairo,Mandalay,Fashion accessories,59.86,2,24,26,22,6,1
Cairo,Mandalay,Food and beverages,54.36,10,31,41,21,3,2
Alex,Yangon,Sports and travel,98.09,9,27,35,18,6,2
Alex,Yangon,Health and beauty,25.43,6,30,52,24,1,2
Alex,Yangon,Fashion accessories,86.68,8,33,25,25,3,1
Cairo,Mandalay,Electronic accessories,22.95,10,39,26,29,2,2
Giza,Naypyitaw,Food and beverages,16.31,9,37,11,28,1,3
Alex,Yangon,Home and lifestyle,28.32,5,26,38,21,0,3
Giza,Naypyitaw,Home and lifestyle,16.67,7,32,2,25,3,2
Cairo,Mandalay,Fashion accessories,73.96,1,26,7,25,5,1
Alex,Yangon,Home and lifestyle,97.94,1,22,18,21,3,3
Alex,Yangon,Fashion accessories,73.05,4,20,27,16,0,2
Giza,Naypyitaw,Food and beverages,87.48,6,25,34,19,4,2
Alex,Yangon,Home and lifestyle,30.68,3,12,27,9,1,1
Giza,Naypyitaw,Health and beauty,75.88,1,6,17,5,3,1
Cairo,Mandalay,Sports and travel,20.18,4,18,43,14,2,2
Giza,Naypyitaw,Electronic accessories,18.77,6,27,59,21,0,1
Cairo,Mandalay,Food and beverages,71.2,1,11,44,10,5,1
Cairo,Mandalay,Home and lifestyle,38.81,4,31,59,27,1,3
Alex,Yangon,Fashion accessories,29.42,10,14,51,4,5,1
Alex,Yangon,Sports and travel,60.95,9,9,54,0,0,1
Cairo,Mandalay,Sports and travel,51.54,5,12,24,7,5,1
Alex,Yangon,Electronic accessories,66.06,6,26,25,20,2,1
Cairo,Mandalay,Fashion accessories,57.27,3,30,7,27,5,2
Cairo,Mandalay,Fashion accessories,54.31,9,20,52,11,4,2
Cairo,Mandalay,Health and beauty,58.24,9,20,6,11,1,2
Giza,Naypyitaw,Electronic accessories,22.21,6,10,53,4,3,3
Alex,Yangon,Electronic accessories,19.32,7,13,24,6,0,3
Cairo,Mandalay,Home and lifestyle,37.48,3,6,33,3,6,1
Cairo,Mandalay,Fashion accessories,72.04,2,7,49,5,0,2
Giza,Naypyitaw,Food and beverages,98.52,10,22,29,12,2,1
Alex,Yangon,Food and beverages,41.66,6,25,43,19,2,1
Alex,Yangon,Home and lifestyle,72.42,3,32,22,29,4,3
Cairo,Mandalay,Electronic accessories,21.58,9,23,26,14,3,3
Giza,Naypyitaw,Food and beverages,89.2,10,12,28,2,0,2
Cairo,Mandalay,Electronic accessories,42.42,8,30,50,22,2,1
Alex,Yangon,Electronic accessories,74.51,6,13,21,7,2,3
Cairo,Mandalay,Fashion accessories,99.25,2,21,49,19,2,3
Alex,Yangon,Food and beverages,81.21,10,25,7,15,3,1
Giza,Naypyitaw,Sports and travel,49.33,10,22,17,12,6,2
Alex,Yangon,Fashion accessories,65.74,9,26,20,17,1,1
Cairo,Mandalay,Fashion accessories,79.86,7,34,41,27,3,1
Giza,Naypyitaw,Sports and travel,73.98,7,16,49,9,5,3
Cairo,Mandalay,Home and lifestyle,82.04,5,34,20,29,0,2
Cairo,Mandalay,Sports and travel,26.67,10,28,54,18,1,1
Alex,Yangon,Food and beverages,10.13,7,23,22,16,6,3
Cairo,Mandalay,Food and beverages,72.39,2,25,28,23,6,1
Alex,Yangon,Sports and travel,85.91,5,23,40,18,4,3
Cairo,Mandalay,Fashion accessories,81.31,7,34,49,27,4,3
Cairo,Mandalay,Food and beverages,60.3,4,29,7,25,2,2
Giza,Naypyitaw,Food and beverages,31.77,4,26,1,22,0,1
Alex,Yangon,Health and beauty,64.27,4,29,32,25,1,3
Cairo,Mandalay,Health and beauty,69.51,2,6,13,4,4,3
Giza,Naypyitaw,Food and beverages,27.22,3,28,30,25,0,1
Alex,Yangon,Health and beauty,77.68,4,24,23,20,4,2
Giza,Naypyitaw,Fashion accessories,92.98,2,31,51,29,2,2
Cairo,Mandalay,Fashion accessories,18.08,4,26,59,22,0,1
Cairo,Mandalay,Sports and travel,63.06,3,11,56,8,5,1
Alex,Yangon,Health and beauty,51.71,4,15,19,11,5,3
Alex,Yangon,Food and beverages,52.34,3,23,32,20,2,3
Alex,Yangon,Sports and travel,43.06,5,5,30,0,0,2
Giza,Naypyitaw,Fashion accessories,59.61,10,35,29,25,3,3
Alex,Yangon,Health and beauty,14.62,5,30,49,25,0,3
Giza,Naypyitaw,Health and beauty,46.53,6,6,45,0,6,3
Giza,Naypyitaw,Home and lifestyle,24.24,7,21,29,14,6,1
Alex,Yangon,Sports and travel,45.58,1,2,30,1,3,2
Alex,Yangon,Sports and travel,75.2,3,32,16,29,1,2
Cairo,Mandalay,Sports and travel,96.8,3,24,40,21,4,3
Cairo,Mandalay,Health and beauty,14.82,3,18,19,15,4,3
Alex,Yangon,Food and beverages,52.2,3,27,18,24,4,2
Giza,Naypyitaw,Sports and travel,46.66,9,16,1,7,6,2
Giza,Naypyitaw,Fashion accessories,36.85,5,17,14,12,5,1
Alex,Yangon,Home and lifestyle,70.32,2,22,51,20,6,3
Giza,Naypyitaw,Electronic accessories,83.08,1,1,47,0,2,1
Giza,Naypyitaw,Fashion accessories,64.99,1,16,50,15,5,1
Giza,Naypyitaw,Food and beverages,77.56,10,38,2,28,3,3
Cairo,Mandalay,Sports and travel,54.51,6,12,54,6,6,3
Giza,Naypyitaw,Fashion accessories,51.89,7,11,28,4,1,1
Cairo,Mandalay,Home and lifestyle,31.75,4,25,49,21,4,2
Alex,Yangon,Fashion accessories,53.65,7,35,50,28,6,2
Giza,Naypyitaw,Food and beverages,49.79,4,26,30,22,3,3
Alex,Yangon,Fashion accessories,30.61,1,3,38,2,2,1
Cairo,Mandalay,Food and beverages,57.89,2,13,51,11,3,1
Alex,Yangon,Electronic accessories,28.96,1,26,4,25,3,2
Giza,Naypyitaw,Food and beverages,98.97,9,24,1,15,5,3
Cairo,Mandalay,Fashion accessories,93.22,3,21,8,18,3,1
Giza,Naypyitaw,Sports and travel,80.93,1,5,29,4,5,1
Alex,Yangon,Food and beverages,67.45,10,31,55,21,6,2
Alex,Yangon,Sports and travel,38.72,9,33,39,24,2,3
Cairo,Mandalay,Sports and travel,72.6,6,34,3,28,6,1
Giza,Naypyitaw,Electronic accessories,87.91,5,18,32,13,3,3
Alex,Yangon,Food and beverages,98.53,6,33,10,27,2,1
Giza,Naypyitaw,Fashion accessories,43.46,6,10,10,4,3,2
Alex,Yangon,Food and beverages,71.68,3,17,19,14,3,3
Alex,Yangon,Food and beverages,91.61,1,17,46,16,2,3
Cairo,Mandalay,Home and lifestyle,94.59,7,36,34,29,3,1
Cairo,Mandalay,Fashion accessories,83.25,10,23,33,13,5,1
Cairo,Mandalay,Fashion accessories,91.35,1,30,23,29,5,2
Cairo,Mandalay,Food and beverages,78.88,2,21,55,19,5,1
Alex,Yangon,Sports and travel,60.87,2,6,28,4,5,3
Cairo,Mandalay,Health and beauty,82.58,10,21,32,11,3,3
Alex,Yangon,Home and lifestyle,53.3,3,18,50,15,4,1
Alex,Yangon,Fashion accessories,12.09,1,26,7,25,5,1
Alex,Yangon,Sports and travel,64.19,10,35,29,25,5,1
Alex,Yangon,Electronic accessories,78.31,3,18,8,15,1,3
Alex,Yangon,Food and beverages,83.77,2,22,1,20,1,1
Cairo,Mandalay,Home and lifestyle,99.7,3,9,57,6,0,3
Cairo,Mandalay,Food and beverages,79.91,3,6,55,3,2,3
Cairo,Mandalay,Health and beauty,66.47,10,10,3,0,1,1
Alex,Yangon,Health and beauty,28.95,7,36,24,29,6,3
Giza,Naypyitaw,Electronic accessories,46.2,1,30,23,29,1,3
Cairo,Mandalay,Food and beverages,17.63,5,9,59,4,4,3
Cairo,Mandalay,Fashion accessories,52.42,3,25,8,22,2,2
Cairo,Mandalay,Food and beverages,98.79,3,28,54,25,5,2
Giza,Naypyitaw,Electronic accessories,88.55,8,17,57,9,1,3
Cairo,Mandalay,Electronic accessories,55.67,2,23,47,21,2,3
Giza,Naypyitaw,Food and beverages,72.52,8,12,37,4,5,3
Giza,Naypyitaw,Electronic accessories,12.05,5,8,3,3,5,2
Alex,Yangon,Home and lifestyle,19.36,9,10,51,1,4,1
Giza,Naypyitaw,Health and beauty,70.21,6,25,33,19,5,3
Cairo,Mandalay,Fashion accessories,33.63,1,10,28,9,2,3
Giza,Naypyitaw,Sports and travel,15.49,2,27,47,25,2,1
Giza,Naypyitaw,Electronic accessories,24.74,10,28,8,18,6,2
Cairo,Mandalay,Electronic accessories,75.66,5,30,34,25,1,1
Cairo,Mandalay,Health and beauty,55.81,6,6,35,0,1,1
Alex,Yangon,Home and lifestyle,72.78,10,33,32,23,6,2
Cairo,Mandalay,Sports and travel,37.32,9,13,24,4,2,3
Cairo,Mandalay,Fashion accessories,60.18,4,16,14,12,5,2
Alex,Yangon,Electronic accessories,15.69,3,6,32,3,3,3
Giza,Naypyitaw,Electronic accessories,99.69,1,16,56,15,2,2
Alex,Yangon,Fashion accessories,88.15,3,26,46,23,4,1
Alex,Yangon,Sports and travel,27.93,5,20,43,15,1,1
Alex,Yangon,Fashion accessories,55.45,1,23,16,22,1,2
Cairo,Mandalay,Sports and travel,42.97,3,4,4,1,6,2
Giza,Naypyitaw,Sports and travel,17.14,7,23,52,16,2,1
Cairo,Mandalay,Fashion accessories,58.75,6,33,37,27,6,3
Giza,Naypyitaw,Food and beverages,87.1,10,36,54,26,1,2
Giza,Naypyitaw,Sports and travel,98.8,2,21,21,19,3,2
Alex,Yangon,Fashion accessories,48.63,4,27,14,23,0,2
Cairo,Mandalay,Food and beverages,57.74,3,14,31,11,2,2
Cairo,Mandalay,Health and beauty,17.97,4,21,55,17,5,2
Giza,Naypyitaw,Health and beauty,47.71,6,8,48,2,5,2
Cairo,Mandalay,Sports and travel,40.62,2,29,18,27,3,1
Alex,Yangon,Fashion accessories,56.04,10,10,7,0,0,1
Cairo,Mandalay,Food and beverages,93.4,2,2,10,0,5,3
Cairo,Mandalay,Health and beauty,73.41,3,31,7,28,5,3
Giza,Naypyitaw,Health and beauty,33.64,8,26,33,18,4,2
Alex,Yangon,Electronic accessories,45.48,10,20,23,10,4,3
Cairo,Mandalay,Fashion accessories,83.77,2,6,21,4,6,2
Cairo,Mandalay,Sports and travel,64.08,7,18,19,11,1,2
Alex,Yangon,Food and beverages,73.47,4,6,48,2,5,2
Giza,Naypyitaw,Health and beauty,58.95,10,10,19,0,3,2
Alex,Yangon,Food and beverages,48.5,6,6,36,0,4,1
Cairo,Mandalay,Electronic accessories,39.48,1,8,29,7,1,2
Cairo,Mandalay,Sports and travel,34.81,1,10,18,9,0,1
Giza,Naypyitaw,Fashion accessories,49.32,6,16,2,10,2,1
Alex,Yangon,Fashion accessories,21.48,2,13,1,11,2,2
Cairo,Mandalay,Sports and travel,23.08,6,34,47,28,3,1
Cairo,Mandalay,Home and lifestyle,49.1,2,14,5,12,1,1
Cairo,Mandalay,Sports and travel,64.83,2,13,20,11,1,1
Alex,Yangon,Home and lifestyle,63.56,10,23,11,13,2,1
Giza,Naypyitaw,Sports and travel,72.88,2,3,42,1,2,3
Alex,Yangon,Food and beverages,67.1,3,31,2,28,4,2
Giza,Naypyitaw,Sports and travel,70.19,9,27,3,18,4,1
Giza,Naypyitaw,Food and beverages,55.04,7,24,23,17,1,3
Alex,Yangon,Health and beauty,48.63,10,12,55,2,0,3
Giza,Naypyitaw,Fashion accessories,73.38,7,29,12,22,6,2
Giza,Naypyitaw,Food and beverages,52.6,9,25,20,16,2,1
Alex,Yangon,Home and lifestyle,87.37,5,30,5,25,1,1
Alex,Yangon,Sports and travel,27.04,4,11,37,7,1,1
Cairo,Mandalay,Home and lifestyle,62.19,4,32,38,28,6,1
Alex,Yangon,Electronic accessories,69.58,9,34,30,25,1,2
Giza,Naypyitaw,Home and lifestyle,97.5,10,19,9,9,5,1
Giza,Naypyitaw,Fashion accessories,60.41,8,33,34,25,3,2
Cairo,Mandalay,Food and beverages,32.32,3,32,53,29,2,3
Cairo,Mandalay,Fashion accessories,19.77,10,11,44,1,2,2
Cairo,Mandalay,Health and beauty,80.47,9,27,35,18,6,1
Cairo,Mandalay,Home and lifestyle,88.39,9,17,52,8,5,3
Cairo,Mandalay,Health and beauty,71.77,7,13,58,6,4,3
Cairo,Mandalay,Electronic accessories,43.0,4,7,22,3,3,1
Giza,Naypyitaw,Food and beverages,68.98,1,26,44,25,0,1
Giza,Naypyitaw,Fashion accessories,15.62,8,28,24,20,6,1
Alex,Yangon,Sports and travel,25.7,3,20,17,17,3,1
Alex,Yangon,Food and beverages,80.62,6,18,10,12,3,2
Giza,Naypyitaw,Home and lifestyle,75.53,4,14,30,10,1,3
Giza,Naypyitaw,Electronic accessories,77.63,9,37,56,28,1,2
Giza,Naypyitaw,Health and beauty,13.85,9,32,59,23,0,2
Giza,Naypyitaw,Fashion accessories,98.7,8,11,46,3,3,1
Alex,Yangon,Health and beauty,35.68,5,29,23,24,2,2
Alex,Yangon,Fashion accessories,71.46,7,27,32,20,3,3
Alex,Yangon,Electronic accessories,11.94,3,31,17,28,5,1
Alex,Yangon,Fashion accessories,45.38,3,27,50,24,6,2
Cairo,Mandalay,Fashion accessories,17.48,6,9,51,3,4,1
Cairo,Mandalay,Fashion accessories,25.56,7,16,17,9,5,2
Giza,Naypyitaw,Sports and travel,90.63,9,13,14,4,4,1
Cairo,Mandalay,Home and lifestyle,44.12,3,11,9,8,0,3
Giza,Naypyitaw,Food and beverages,36.77,7,30,40,23,4,1
Cairo,Mandalay,Food and beverages,23.34,4,6,2,2,0,2
Giza,Naypyitaw,Health and beauty,28.5,8,24,45,16,2,2
Giza,Naypyitaw,Home and lifestyle,55.57,3,5,25,2,1,1
Cairo,Mandalay,Sports and travel,69.74,10,25,39,15,1,3
Giza,Naypyitaw,Fashion accessories,97.26,4,7,9,3,5,3
Cairo,Mandalay,Home and lifestyle,52.18,7,24,54,17,5,3
Alex,Yangon,Fashion accessories,22.32,4,20,22,16,4,3
Alex,Yangon,Health and beauty,56.0,3,9,43,6,3,2
Alex,Yangon,Fashion accessories,19.7,1,24,46,23,4,2
Cairo,Mandalay,Electronic accessories,75.88,7,29,4,22,3,1
Cairo,Mandalay,Food and beverages,53.72,1,30,26,29,4,3
Giza,Naypyitaw,Health and beauty,81.95,10,14,58,4,6,3
Giza,Naypyitaw,Home and lifestyle,81.2,7,18,29,11,5,3
Giza,Naypyitaw,Electronic accessories,58.76,10,26,45,16,1,1
Cairo,Mandalay,Electronic accessories,91.56,8,30,34,22,5,1
Alex,Yangon,Home and lifestyle,93.96,9,21,23,12,2,3
Giza,Naypyitaw,Home and lifestyle,55.61,7,29,37,22,5,3
Giza,Naypyitaw,Food and beverages,84.83,1,25,11,24,0,1
Alex,Yangon,Sports and travel,71.63,2,4,6,2,1,2
Alex,Yangon,Home and lifestyle,37.69,2,10,18,8,2,2
Giza,Naypyitaw,Sports and travel,31.67,8,37,21,29,2,1
Giza,Naypyitaw,Food and beverages,38.42,1,17,42,16,5,2
Cairo,Mandalay,Fashion accessories,65.23,10,26,36,16,1,1
Giza,Naypyitaw,Home and lifestyle,10.53,5,34,41,29,2,1
Cairo,Mandalay,Home and lifestyle,12.29,9,28,38,19,1,3
Giza,Naypyitaw,Health and beauty,81.23,7,22,34,15,1,1
Cairo,Mandalay,Fashion accessories,22.32,4,28,17,24,3,3
Alex,Yangon,Food and beverages,27.28,5,26,37,21,6,2
Alex,Yangon,Electronic accessories,17.42,10,22,25,12,4,2
Cairo,Mandalay,Home and lifestyle,73.28,5,31,38,26,3,1
Giza,Naypyitaw,Fashion accessories,84.87,3,21,58,18,4,1
Alex,Yangon,Fashion accessories,97.29,8,24,12,16,5,3
Cairo,Mandalay,Electronic accessories,35.74,8,11,23,3,6,2
Alex,Yangon,Home and lifestyle,96.52,6,17,53,11,4,1
Alex,Yangon,Food and beverages,18.85,10,38,42,28,2,2
Alex,Yangon,Food and beverages,55.39,4,12,22,8,0,3
Cairo,Mandalay,Food and beverages,77.2,10,28,21,18,0,2
Cairo,Mandalay,Electronic accessories,72.13,10,21,27,11,3,1
Alex,Yangon,Fashion accessories,63.88,8,16,57,8,6,1
Alex,Yangon,Health and beauty,10.69,5,11,31,6,1,3
Alex,Yangon,Health and beauty,55.5,4,31,6,27,6,1
Cairo,Mandalay,Home and lifestyle,95.46,8,21,27,13,1,3
Giza,Naypyitaw,Fashion accessories,76.06,3,22,40,19,5,1
Cairo,Mandalay,Sports and travel,13.69,6,24,34,18,2,2
Cairo,Mandalay,Electronic accessories,95.64,4,29,12,25,5,3
Alex,Yangon,Home and lifestyle,11.43,6,20,45,14,1,1
Cairo,Mandalay,Sports and travel,95.54,4,19,57,15,1,2
Giza,Naypyitaw,Health and beauty,85.87,7,27,53,20,2,2
Giza,Naypyitaw,Sports and travel,67.99,7,11,7,4,6,2
Giza,Naypyitaw,Food and beverages,52.42,1,3,10,2,2,2
Giza,Naypyitaw,Food and beverages,65.65,2,13,45,11,3,1
Cairo,Mandalay,Food and beverages,28.86,5,29,17,24,1,1
Giza,Naypyitaw,Health and beauty,65.31,7,26,26,19,1,3
Cairo,Mandalay,Sports and travel,93.38,1,27,21,26,3,1
Giza,Naypyitaw,Sports and travel,25.25,5,25,28,20,2,3
Cairo,Mandalay,Electronic accessories,87.87,9,12,58,3,3,1
Giza,Naypyitaw,Health and beauty,21.8,8,28,46,20,1,2
Alex,Yangon,Sports and travel,94.76,4,26,2,22,0,2
Alex,Yangon,Fashion accessories,30.62,1,16,54,15,1,2
Giza,Naypyitaw,Home and lifestyle,44.01,8,32,43,24,6,3
Giza,Naypyitaw,Health and beauty,10.16,5,11,1,6,6,2
Alex,Yangon,Electronic accessories,74.58,7,19,51,12,0,2
Giza,Naypyitaw,Electronic accessories,71.89,8,28,53,20,1,2
Giza,Naypyitaw,Health and beauty,10.99,5,14,36,9,2,1
Giza,Naypyitaw,Health and beauty,60.47,3,28,51,25,0,1
Alex,Yangon,Sports and travel,58.91,7,13,26,6,3,1
Alex,Yangon,Fashion accessories,46.41,1,14,29,13,6,3
Giza,Naypyitaw,Health and beauty,68.55,4,29,21,25,4,2
Cairo,Mandalay,Home and lifestyle,97.37,10,14,11,4,1,1
Alex,Yangon,Electronic accessories,92.6,7,9,40,2,2,2
Alex,Yangon,Electronic accessories,46.61,2,24,11,22,1,2
Cairo,Mandalay,Fashion accessories,27.18,2,30,36,28,4,3
Giza,Naypyitaw,Home and lifestyle,60.87,1,11,49,10,3,1
Alex,Yangon,Sports and travel,24.49,10,20,59,10,4,2
Cairo,Mandalay,Health and beauty,92.78,1,18,39,17,4,3
Giza,Naypyitaw,Home and lifestyle,86.69,5,19,40,14,0,2
Cairo,Mandalay,Sports and travel,23.01,6,17,35,11,5,1
Giza,Naypyitaw,Electronic accessories,30.2,8,16,54,8,6,3
Giza,Naypyitaw,Fashion accessories,67.39,7,16,34,9,5,3
Alex,Yangon,Fashion accessories,48.96,9,34,55,25,0,3
Cairo,Mandalay,Electronic accessories,75.59,9,20,47,11,5,2
Alex,Yangon,Home and lifestyle,77.47,4,20,24,16,6,3
Alex,Yangon,Sports and travel,93.18,2,30,54,28,2,1
Alex,Yangon,Electronic accessories,50.23,4,9,22,5,1,1
Cairo,Mandalay,Health and beauty,17.75,1,7,5,6,0,1
Giza,Naypyitaw,Fashion accessories,62.18,10,23,56,13,3,1
Cairo,Mandalay,Health and beauty,10.75,8,20,33,12,4,3
Alex,Yangon,Electronic accessories,40.26,10,17,58,7,6,2
Giza,Naypyitaw,Sports and travel,64.97,5,14,36,9,4,2
Alex,Yangon,Electronic accessories,95.15,1,9,47,8,4,3
Alex,Yangon,Electronic accessories,48.62,8,25,20,17,3,1
Cairo,Mandalay,Food and beverages,53.21,8,34,19,26,3,3
Giza,Naypyitaw,Fashion accessories,45.44,7,32,35,25,2,1
Alex,Yangon,Food and beverages,33.88,8,9,52,1,5,1
Cairo,Mandalay,Health and beauty,96.16,4,8,43,4,6,1
Cairo,Mandalay,Food and beverages,47.16,5,33,17,28,6,2
Cairo,Mandalay,Electronic accessories,52.89,4,8,59,4,0,3
Alex,Yangon,Home and lifestyle,47.68,2,7,45,5,6,2
Giza,Naypyitaw,Sports and travel,10.17,1,19,43,18,3,2
Alex,Yangon,Health and beauty,68.71,3,10,34,7,0,3
Cairo,Mandalay,Sports and travel,60.08,7,22,9,15,3,2
Alex,Yangon,Sports and travel,22.01,4,16,26,12,1,1
Cairo,Mandalay,Health and beauty,72.11,9,9,2,0,0,1
Alex,Yangon,Fashion accessories,41.28,3,24,53,21,1,3
Giza,Naypyitaw,Electronic accessories,64.95,10,29,9,19,6,3
Alex,Yangon,Electronic accessories,74.22,10,26,9,16,1,1
Alex,Yangon,Electronic accessories,10.56,8,14,40,6,3,1
Cairo,Mandalay,Health and beauty,62.57,4,28,17,24,0,2
Cairo,Mandalay,Sports and travel,11.85,8,20,1,12,2,1
Alex,Yangon,Health and beauty,91.3,1,4,25,3,3,2
Cairo,Mandalay,Home and lifestyle,40.73,7,10,43,3,1,3
Alex,Yangon,Fashion accessories,52.38,1,6,40,5,1,3
Alex,Yangon,Fashion accessories,38.54,5,32,42,27,2,1
Cairo,Mandalay,Sports and travel,44.63,6,24,25,18,2,1
Giza,Naypyitaw,Electronic accessories,55.87,10,38,39,28,1,1
Giza,Naypyitaw,Sports and travel,29.22,6,17,35,11,1,1
Alex,Yangon,Fashion accessories,51.94,3,24,3,21,4,2
Cairo,Mandalay,Electronic accessories,60.3,1,7,50,6,3,2
Alex,Yangon,Sports and travel,39.47,2,28,37,26,5,3
Giza,Naypyitaw,Food and beverages,14.87,2,11,44,9,2,2
Alex,Yangon,Fashion accessories,21.32,1,26,44,25,5,1
Alex,Yangon,Electronic accessories,93.78,3,21,51,18,2,1
Alex,Yangon,Electronic accessories,73.26,1,7,30,6,6,1
Giza,Naypyitaw,Sports and travel,22.38,1,30,38,29,2,1
Giza,Naypyitaw,Food and beverages,72.88,9,11,34,2,1,1
Alex,Yangon,Fashion accessories,99.1,6,18,12,12,5,1
Alex,Yangon,Fashion accessories,74.1,1,13,19,12,4,1
Alex,Yangon,Fashion accessories,98.48,2,19,37,17,1,2
Giza,Naypyitaw,Health and beauty,53.19,7,34,44,27,0,1
Cairo,Mandalay,Electronic accessories,52.79,10,39,59,29,0,2
Alex,Yangon,Health and beauty,95.95,5,30,59,25,2,1
Cairo,Mandalay,Fashion accessories,36.51,9,28,49,19,5,2
Cairo,Mandalay,Food and beverages,21.12,8,35,17,27,1,1
Alex,Yangon,Home and lifestyle,28.31,4,11,10,7,3,3
Cairo,Mandalay,Health and beauty,57.59,6,34,57,28,4,2
Alex,Yangon,Food and beverages,47.63,9,17,55,8,2,1
Giza,Naypyitaw,Home and lifestyle,86.27,1,7,49,6,2,2
Alex,Yangon,Sports and travel,12.76,2,2,47,0,1,1
Cairo,Mandalay,Home and lifestyle,11.28,9,11,12,2,6,3
Cairo,Mandalay,Home and lifestyle,51.07,7,19,16,12,5,1
Alex,Yangon,Electronic accessories,79.59,3,30,24,27,1,1
Giza,Naypyitaw,Health and beauty,33.81,3,32,19,29,5,1
Cairo,Mandalay,Sports and travel,90.53,8,32,8,24,4,3
Giza,Naypyitaw,Health and beauty,62.82,2,29,31,27,3,1
Giza,Naypyitaw,Food and beverages,24.31,3,19,21,16,1,1
Alex,Yangon,Sports and travel,64.59,4,28,17,24,6,1
Alex,Yangon,Food and beverages,24.82,7,30,23,23,5,2
Giza,Naypyitaw,Fashion accessories,56.5,1,1,37,0,2,3
Cairo,Mandalay,Electronic accessories,21.43,10,15,54,5,0,1
Alex,Yangon,Sports and travel,89.06,6,26,16,20,4,1
Alex,Yangon,Home and lifestyle,23.29,4,9,6,5,1,3
Giza,Naypyitaw,Home and lifestyle,65.26,8,33,8,25,4,3
Giza,Naypyitaw,Fashion accessories,52.35,1,12,25,11,1,2
Cairo,Mandalay,Electronic accessories,39.75,1,13,18,12,0,2
Alex,Yangon,Electronic accessories,90.02,8,20,25,12,3,3
Cairo,Mandalay,Electronic accessories,12.1,8,36,12,28,5,1
Cairo,Mandalay,Food and beverages,33.21,10,24,15,14,1,1
Giza,Naypyitaw,Fashion accessories,10.18,8,28,59,20,5,3
Cairo,Mandalay,Sports and travel,31.99,10,25,26,15,2,2
Alex,Yangon,Home and lifestyle,34.42,6,27,41,21,5,3
Alex,Yangon,Food and beverages,83.34,2,22,45,20,1,3
Alex,Yangon,Sports and travel,45.58,7,17,26,10,6,1
Alex,Yangon,Food and beverages,87.9,1,28,47,27,1,2
Alex,Yangon,Electronic accessories,73.47,10,14,32,4,5,3
Giza,Naypyitaw,Fashion accessories,12.19,8,11,10,3,2,3
Alex,Yangon,Sports and travel,76.92,10,12,16,2,6,3
Giza,Naypyitaw,Health and beauty,83.66,5,23,7,18,3,2
Cairo,Mandalay,Electronic accessories,57.91,8,27,17,19,3,2
Giza,Naypyitaw,Fashion accessories,92.49,5,29,23,24,5,3
Cairo,Mandalay,Electronic accessories,28.38,5,22,26,17,2,3
Cairo,Mandalay,Electronic accessories,50.45,6,20,21,14,2,2
Cairo,Mandalay,Health and beauty,99.16,8,16,22,8,0,1
Giza,Naypyitaw,Fashion accessories,60.74,7,23,58,16,4,1
Giza,Naypyitaw,Food and beverages,47.27,6,19,7,13,1,2
Giza,Naypyitaw,Health and beauty,85.6,7,21,14,14,5,3
Alex,Yangon,Food and beverages,35.04,9,9,15,0,5,2
Giza,Naypyitaw,Electronic accessories,44.84,9,29,53,20,0,1
Cairo,Mandalay,Home and lifestyle,45.97,4,25,7,21,5,2
Alex,Yangon,Health and beauty,27.73,5,26,9,21,1,3
Alex,Yangon,Food and beverages,11.53,7,9,51,2,0,1
Giza,Naypyitaw,Health and beauty,58.32,2,17,48,15,3,2
Giza,Naypyitaw,Home and lifestyle,78.38,4,26,8,22,6,3
Giza,Naypyitaw,Health and beauty,84.61,10,34,50,24,5,2
Cairo,Mandalay,Health and beauty,82.88,5,15,59,10,6,3
Alex,Yangon,Food and beverages,79.54,2,13,23,11,2,3
Cairo,Mandalay,Home and lifestyle,49.01,10,19,29,9,6,1
Cairo,Mandalay,Food and beverages,29.15,3,18,18,15,2,3
Giza,Naypyitaw,Electronic accessories,56.13,4,11,31,7,5,1
Alex,Yangon,Home and lifestyle,93.12,8,13,30,5,3,2
Alex,Yangon,Fashion accessories,51.34,8,19,52,11,3,1
Alex,Yangon,Food and beverages,99.6,3,26,39,23,0,2
Giza,Naypyitaw,Electronic accessories,35.49,6,33,35,27,5,2
Giza,Naypyitaw,Sports and travel,42.85,1,21,18,20,3,3
Alex,Yangon,Fashion accessories,94.67,4,11,59,7,0,3
Cairo,Mandalay,Home and lifestyle,68.97,3,28,42,25,4,2
Cairo,Mandalay,Electronic accessories,26.26,3,30,39,27,5,3
Giza,Naypyitaw,Home and lifestyle,35.79,9,12,17,3,6,3
Cairo,Mandalay,Home and lifestyle,16.37,6,31,14,25,4,2
Giza,Naypyitaw,Home and lifestyle,12.73,2,9,31,7,4,2
Giza,Naypyitaw,Sports and travel,83.14,7,32,24,25,3,1
Giza,Naypyitaw,Sports and travel,35.22,6,33,35,27,3,3
Cairo,Mandalay,Electronic accessories,13.78,4,21,44,17,3,1
Cairo,Mandalay,Sports and travel,88.31,1,28,45,27,4,2
Alex,Yangon,Health and beauty,39.62,9,36,34,27,6,1
Cairo,Mandalay,Electronic accessories,88.25,9,13,3,4,4,2
Cairo,Mandalay,Sports and travel,25.31,2,10,37,8,5,3
Cairo,Mandalay,Home and lifestyle,99.92,6,9,43,3,6,3
Giza,Naypyitaw,Fashion accessories,83.35,2,28,40,26,5,2
Alex,Yangon,Food and beverages,74.44,10,31,26,21,2,2
Giza,Naypyitaw,Health and beauty,64.08,7,23,55,16,6,1
Cairo,Mandalay,Home and lifestyle,63.15,6,14,23,8,3,1
Giza,Naypyitaw,Home and lifestyle,85.72,3,3,44,0,3,1
Giza,Naypyitaw,Health and beauty,78.89,7,27,39,20,5,1
Alex,Yangon,Sports and travel,89.48,5,24,15,19,5,3
Alex,Yangon,Health and beauty,92.09,3,15,56,12,6,2
Giza,Naypyitaw,Food and beverages,57.29,6,33,49,27,3,3
Alex,Yangon,Food and beverages,66.52,4,19,4,15,5,3
Giza,Naypyitaw,Fashion accessories,99.82,9,37,29,28,2,3
Alex,Yangon,Home and lifestyle,45.68,10,22,22,12,5,1
Alex,Yangon,Health and beauty,50.79,5,18,25,13,1,2
Alex,Yangon,Health and beauty,10.08,7,9,13,2,3,3
Alex,Yangon,Electronic accessories,93.88,7,35,18,28,5,1
Giza,Naypyitaw,Electronic accessories,84.25,2,7,33,5,1,3
Cairo,Mandalay,Fashion accessories,53.78,1,18,16,17,6,2
Giza,Naypyitaw,Home and lifestyle,35.81,5,23,45,18,2,2
Cairo,Mandalay,Food and beverages,26.43,8,12,42,4,6,2
Cairo,Mandalay,Health and beauty,39.91,3,17,44,14,3,2
Cairo,Mandalay,Home and lifestyle,21.9,3,27,2,24,2,1
Cairo,Mandalay,Food and beverages,62.85,4,5,55,1,0,2
Giza,Naypyitaw,Food and beverages,21.04,4,13,35,9,6,1
Cairo,Mandalay,Home and lifestyle,65.91,6,29,42,23,5,2
Alex,Yangon,Fashion accessories,42.57,7,36,34,29,6,1
Giza,Naypyitaw,Food and beverages,50.49,9,26,30,17,3,1
Cairo,Mandalay,Electronic accessories,46.02,6,32,59,26,3,2
Giza,Naypyitaw,Home and lifestyle,15.8,10,22,55,12,2,1
Alex,Yangon,Food and beverages,98.66,9,13,13,4,1,2
Giza,Naypyitaw,Fashion accessories,91.98,1,23,13,22,0,3
Alex,Yangon,Electronic accessories,20.89,2,25,18,23,1,2
Alex,Yangon,Fashion accessories,15.5,1,1,32,0,1,3
Giza,Naypyitaw,Electronic accessories,96.82,3,24,32,21,5,3
Cairo,Mandalay,Food and beverages,33.33,2,2,35,0,5,1
Cairo,Mandalay,Electronic accessories,38.27,2,19,59,17,5,3
Alex,Yangon,Home and lifestyle,33.3,9,23,39,14,0,3
Alex,Yangon,Home and lifestyle,81.01,3,19,46,16,6,1
Alex,Yangon,Health and beauty,15.8,3,13,52,10,0,3
Cairo,Mandalay,Electronic accessories,34.49,5,25,29,20,0,3
Cairo,Mandalay,Food and beverages,84.63,10,35,49,25,1,1
Cairo,Mandalay,Home and lifestyle,36.91,7,31,29,24,6,2
Cairo,Mandalay,Electronic accessories,87.08,7,28,53,21,5,1
Alex,Yangon,Home and lifestyle,80.08,3,29,44,26,0,2
Giza,Naypyitaw,Fashion accessories,86.13,2,28,57,26,3,2
Cairo,Mandalay,Fashion accessories,49.92,2,18,16,16,2,3
Alex,Yangon,Food and beverages,74.66,4,16,56,12,0,3
Cairo,Mandalay,Food and beverages,26.6,6,6,44,0,1,2
Cairo,Mandalay,Electronic accessories,25.45,1,2,47,1,6,3
Cairo,Mandalay,Food and beverages,67.77,1,9,57,8,0,2
Giza,Naypyitaw,Food and beverages,59.59,4,6,10,2,5,1
Alex,Yangon,Health and beauty,58.15,4,4,30,0,2,1
Alex,Yangon,Sports and travel,97.48,9,29,25,20,3,3
Giza,Naypyitaw,Health and beauty,99.96,7,22,39,15,2,1
Giza,Naypyitaw,Electronic accessories,96.37,7,29,20,22,2,1
Cairo,Mandalay,Fashion accessories,63.71,5,10,5,5,3,2
Cairo,Mandalay,Health and beauty,14.76,2,29,1,27,0,2
Cairo,Mandalay,Health and beauty,62.0,8,24,30,16,3,1
Giza,Naypyitaw,Electronic accessories,82.34,10,14,49,4,4,3
Cairo,Mandalay,Health and beauty,75.37,8,12,3,4,0,1
Alex,Yangon,Food and beverages,56.56,5,10,45,5,4,3
Cairo,Mandalay,Sports and travel,76.6,10,12,14,2,3,1
Alex,Yangon,Electronic accessories,58.03,2,22,56,20,6,3
Cairo,Mandalay,Fashion accessories,17.49,10,32,30,22,4,2
Giza,Naypyitaw,Electronic accessories,60.95,1,5,50,4,0,2
Giza,Naypyitaw,Health and beauty,40.35,1,21,4,20,1,1
Cairo,Mandalay,Home and lifestyle,97.38,10,14,18,4,5,3
Alex,Yangon,Food and beverages,31.84,1,10,37,9,5,2
Alex,Yangon,Home and lifestyle,65.82,1,10,25,9,4,2
Alex,Yangon,Fashion accessories,88.34,7,25,48,18,0,2
